FRUCTIFICATIO. 63

 

Laciniae pJaeskz—rtim ig Monophyllis numerat}
nte er: em a.
Bffidgus: Utriffularia.
Trifidus: Alaina, Cliffortia.
Quadrifidus: Rhinanthus.
Quinquefidus : N icotiana.
Sexfidus : Pavia.
Uetofidus: Tormentilla.
Decemfidus: Potentilla‚ Fragaria.
Duodecemfidus : Lythrmn.

. AEqual. AEqualis: Lychnis.
v· - Inaequalis: Helianthemum. Tournefi
alternis brevioribus . Tomnentilla, Potentilla.

Figura: Globosus: Cucuhalus.
Clavatus: Silene.
Reflexus: Asklepias.
Ereems : Primula ‚ N icotiana.

Margo .· Integerrimus: Plerisque.
Serratus: Hyperici speeies.
Ciliatus: Ce'nmureae sp.
Apex : Acutus: Famula, Andrcffizce.
Acuminatus: Hycyaffyamus.
Obtusus τ N ymphaea, Garcz‘uia.
Unico dentikulo truncato: Verhena.
Proportio .· Corona longior z Agrqstemffi Sagitta, Antirrhini sp,
Corollae aequalis: Cerastzi sp.
Corolla brevior: Silene.
Locus .· Flosis: Linum, Μοιηηα.
Fructus: Linum, Morina.
Fruffificationis: Poeonia.
Duratio: Cadmus, ad primam explicationem Floris: Pa-
pnver ‚ Epimedimn.
Deciduus eum Corolla3 Tetradynamia, Rea-heris.
Perssstens ad maturitatem frqus: Dicgynamia.

INVOLUCRUM Monophvllum: Bupleurum.
Diphyllum: Eup'horbia.
'l'riphyllum. Butomus, Alg'fiua.
Tetraphyllum: Cornus.
Pentaphyllum .· Damus.

Hexaphyssum.· Haemanthus. QPA

