66 FRucrIFICAT1o.

Tres in singulo filamento: Fumaria.
Quinque in tribus filamentis : Bryonia.
in fingulo filamento: Theobroma.
Loculo unico: [Mercurialis.
gemino: Hellehorus.
trino: orchis.
quaterno: Fritillaria.
DefeHu unius: Chelone, Martynia.
Duorum: Pinguicula, V erbena.
Trium: Gratiola, Bzgnonm, Gerania.
Quattuor: Cura-uma.
Quinque: Pentapetes‚ Gerania.
Figura Oblonga: Lilzum.
Globosa: Mercurialis.
Sagittata: Crocus.
Angulata: Tzclipa.
ᾖ Cornuta: Hamamelis‚Erica‚Vaccinia‚Pyr0l‹1.
Dehzscentia Latere; Plerique, Leucojum.
Apice ε Calamina, Kigg‘elaria.
a ssafi acl Apicem discedens: Epime-
dium, Leontice.
connexione Apice: Colchicum.
Bafi: Plerique.
Latere: Canna.
Νεὸὶειτίοε Cqstus.
Situs in Filamentis apice: Plerique.
latere: Paris, Asterum.
Pistillo ι Aristolochia.

Receptaculo t Arum.

Ροιιεκ figura: globus echinatus: Helianthus„ ι
perforatus: Geramum.
didymus: Symphytum.
rotatus dent'gntus: Malva.
angulatus: V mla.
ren‘iformis: Narczffits,

Philyra convoluta: Rari-ago.

 

1027 1³1³„

